
Rue Saint-Vincent (Rose blanche) — Yves Montand
Break — Beenzino **
Everything — The Black Skirts
The Hero — Moods (Dancing mood)
Rollercoaster — David Choi **
Candy Says — The Velvet Underground
Sea of Love — Lily & Madeleine
Countdown — Sounder Lerche
Ewe — Fabiano Do Nascimento (Dancing mood) 
Green Bird — Sebastian Wolff **
Orchids — Monster Rally
Love Theme From Spartacus — Yosef Lateef 
Bewitched, Bothered, And Bewildered — Ella Fitzgerald **
Lob Stop Sta — Boom Clap Bachelors
Sweet Creature — Harry Styles
The Sound of Someone You Love Who’s Going Away — Penguin Cafe Orchestra
Phantom Other — Department of Eagles
Swing Lo Magellan — Dirty Projects
Human Racing — Saint Vincent
No Other Love — Jo Stafford
Feel Good Inc — Gorillaz
Hong Kong — Gorillaz
Say You Love Me — MYMP
The Most Beautiful Song — Kita & The Faces
Just In Time — Nina Simone
Yumeji’s Theme — Shigeru Umebayashi
New York, I Love You But You’re Bringing Me Down — LCD Soundsystem
The Long Grift — Hedwig And The Angry Inch
Ukelele Anthem — Amanda Palmer
Azul — Natalia Lafourcade
Lengths — The Black Keys
Come Here — Bath Bloom
Etude — Joep Beving
Trouble — Yusuf/Cat Stevens
“Adante” from Sonata for Viola da Gamba in G Major — Lawrence Dreyfus and Ketil Haugsand
By The Sleepy Lagoon — Eric Coates
WEIGHT OFF — KAYTRANADA, BadBadNotGood
Aqueous Transmission — Incubus
Evaporar — Little Joy
It Never Entered My Mind — Miles Davis Quintet
Ma’agalim — Jane Bordeaux
When It Rains — Brad Mehldau
I Know — Fiona Apple
I Don’t Know — Peter and Kerry
Off You — The Breeders
Good Love — Dynaimic Duo, Kim Bum Son
If You Knew — Jeff Buckley
Hallelujah — Jeff Buckley
꿈꾸는 나비 — 3rd Line Butterfly
Brain Stew — Green Day
Melissa — Polar
Hate To See Your Heart Break — Paramore 
In My Life — Jake Shimabukuro
Release You — Tom Misch, Carmody
Chaconne in G Minor — Tomaso Antonio Vitali
Say It Ain’t So — Weezer
Romain — Bill Evans
Comme une rosée de larmes — Ludovic Bource
Stay — Daniela Andrade
Water — Lauren Hill
Another Rainy Day — Corrinne Baily Rae
내시 이상해 — Lee Hi
Her Smoke Rose Up Forever — James Blackshaw
Piece Piece — Bill Evans
Only The Ocean — Jack Johnson
I want You, but I don’t Need You — Amanda Palmer
